COUNTRIES = {
	c:AOZ = {
		set_next_election_date = 1946.10.20
		set_tax_level = very_high		#ww2 tax rates were at 94% for the highest bracket.
		effect_starting_technology_tier_1_tech = yes
		effect_starting_technology_wartime_participant_tech = yes

		effect_create_law_package = {
			headOfGovernment = administrative
			distributionOfPower = autocracy
			criminalJustice = arbitrary_justice
			centralization = federalized
			discrimination = integrationist
			churchAndState = religious_policies
			bureaucraticSystems = appointed_bureaucrats
			policing = decentralized_police
			nationalDefense = disarmed_nation
			economicSystem = interventionism
			tradePolicy = export_orientation
			taxation = wealth_taxation
			educationSystem = mixed_funded_schools
			healthSystem = universal_healthcare
			environmentalRegulations = no_environment_regulations
			corporateAffairs = corporate_friendly_policies
			nationalization = public_utility_companies
			monetaryPolicy = gold_standard
			wmds = no_wmds
			freeSpeech = censorship
			laborRights = standard_workweeks
			childrensRights = compulsory_education
			rightsOfWomen = women_in_the_workplace
			familyPlanning = no_family_planning
			welfare = income_supplementation
			migration = selective_immigration
			biotech = unrestricted_human_testing
			recreationalDrugs = alcohol_allowed
		}
		
		#Igs
		ig:ig_entrepreneurs = {
			set_ig_suppression = yes
		}
		ig:ig_patriots = {
			set_ig_suppression = yes
		}
		add_technology_researched = mechanical_computers
	}
}
