COUNTRIES = {
	c:AZR = {
		set_tax_level = very_high
		effect_starting_technology_tier_5_tech = yes
		add_technology_researched = international_relations
		effect_create_law_package = {
			headOfGovernment = council_elective
			distributionOfPower = oligarchy
			criminalJustice = labor_camps
			centralization = devolved
			discrimination = segregationist
			churchAndState = state_atheism
			bureaucraticSystems = politicized_bureaucrats
			policing = professional_police
			nationalDefense = reserve_military
			economicSystem = socialization
			tradePolicy = protectionism
			taxation = capital_gains
			educationSystem = state_funded_schools
			healthSystem = universal_healthcare
			environmentalRegulations = no_environment_regulations
			corporateAffairs = state_run_corporations
			nationalization = total_nationalization
			wmds = deterrence
			freeSpeech = censorship
			laborRights = standard_workweeks
			childrensRights = compulsory_education
			rightsOfWomen = legal_guardianship
			familyPlanning = criminalized_birth_control
			welfare = welfare_state
			migration = open_borders
			biotech = animal_testing_only
			recreationalDrugs = tobacco_allowed
		}
	}
}
