COUNTRIES = {
	c:KUR = {
		set_tax_level = very_high
		effect_starting_technology_tier_5_tech = yes
		effect_starting_pop_wealth_abysmal = yes
		effect_starting_pop_literacy_low = yes
		effect_create_law_package = {
			GOVERNMENT = council_republic
			VOTING = anarchy
			JUDICIARY = no_due_process
			CENTRALIZATION = decentralized
			CITIZENSHIP = racial_segregation
			RELIGION = state_atheism
			BUREAUCRACY = politicized_administrators
			MILITARY = guerilla_army
			CONSCRIPTION = total_conscription
			INTERNAL_SECURITY = no_intelligence_agency
			ECONOMICS = cooperative_ownership
			TRADE = protectionism
			TAXATION = land_based_taxation
			POLICING = no_police
			EDUCATION = no_schools
			HIGHER_EDUCATION = no_higher_education
			HEALTHCARE = no_health_system
			ENVIRONMENT = no_environmental_regulations
			CORPORATIONS = no_corporation_focus
			NUCLEAR = nuclear_disarmament
			SPEECH = right_of_assembly
			PRESS = state_media
			LABOR = independent_unions
			CHILDREN = child_labor_allowed
			WOMEN = women_in_the_workplace
			ABORTION = abortion_prohibited
			WELFARE = no_social_security
			MIGRATION = closed_borders
			WMD = no_wmd
			DRUGS = no_drug_policy
		}
	}
}
