COUNTRIES = {
	c:SWI = {
		# Politics
		effect_un_observer = yes
		# Laws
		effect_create_law_package = {
			headOfGovernment = executive
			distributionOfPower = representative_democracy
			criminalJustice = penal_correction
			centralization = federalized
			discrimination = segregationist
			churchAndState = church_disestablishment
			bureaucraticSystems = appointed_bureaucrats
			policing = professional_police
			nationalDefense = reserve_military
			economicSystem = free_market
			tradePolicy = free_trade
			taxation = capital_gains
			educationSystem = private_schools
			healthSystem = private_health_insurance
			environmentalRegulations = no_environment_regulations
			corporateAffairs = corporate_friendly_policies
			nationalization = no_nationalization
			wmds = deterrence
			freeSpeech = right_of_assembly
			laborRights = workplace_safety_standards
			childrensRights = compulsory_education
			rightsOfWomen = women_in_the_workplace
			familyPlanning = no_family_planning
			welfare = poor_laws
			migration = selective_immigration
			biotech = theoretical_research_only
			recreationalDrugs = tobacco_allowed
		}
		# Tech and Tax
		set_tax_level = high
		effect_starting_technology_tier_1_tech = yes
		# Institutions
	}
}
